XXXXXXXXXXXXXXXXXXXXXXXXXXXXZ
X            XX            XZ
X XXXX XXXXX XX XXXXX XXXX XZ
X X  X X   X XX X   X X  X XZ
X XXXX XXXXX XX XXXXX XXXX XZ
X                          XZ
X XXXX XX XXXXXXXX XX XXXX XZ
X XXXX XX XXXXXXXX XX XXXX XZ
X      XX    XX    XX      XZ
XXXXXX XXXXX XX XXXXX XXXXXXZ
     X XXXXX XX XXXXX X     Z
     X XX          XX X     Z
     X XX XXX__XXX XX X     Z
XXXXXX XX X   P  X XX XXXXXXZ
          X P  P X          Z
XXXXXX XX X      X XX XXXXXXZ
     X XX XXXXXXXX XX X     Z
     X XX          XX X     Z
     X XX XXXXXXXX XX X     Z
XXXXXX XX XXXXXXXX XX XXXXXXZ
X            XX            XZ
X XXXX XXXXX XX XXXXX XXXX XZ
X XXXX XXXXX XX XXXXX XXXX XZ
X   XX       C        XX   XZ
XXX XX XX XXXXXXXX XX XX XXXZ
XXX XX XX XXXXXXXX XX XX XXXZ
X      XX    XX    XX      XZ
X XXXXXXXXXX XX XXXXXXXXXX XZ
X XXXXXXXXXX XX XXXXXXXXXX XZ
X                          XZ
XXXXXXXXXXXXXXXXXXXXXXXXXXXXZ
